.........#.........#...............#...................................
.#####.###.##..#.#.#........##.####....................................
.#...#.......#.#.#.#...........#.....#.................................
##.#.#######.#.#.#.##.######.###.#.....................................
...#.......#...#.#...#.....#.#...#.....................................
.#########.#.###.###.#.###.#.#.##..##..#...............................
.....#...#.#.#...#.....#.....#.#...#...................................
.###.#.###.###.#..####.#######.#####..#................................
.#.#.#.....#...#.#...#.#.......#.......................................
.#...#####.#.#..##.#..##.####.#.....#..................................
...#.....#...#.#...#.#...#...#.........................................
##.#####.#######.###.#.###.......#.....................................
...#...#.#.....#.#.#...#...#...........#...............................
.#####.#.#.###.#.#.####.#.......#......................................
.#...#.#...#.#.#.#.....................................................
.#.#.#.#####.#.#.#...#....#............................................
...#.......#.#...#.#...................................................
##########.#.####....##......#.........................................
.....#...#.#...........#...............................................
.#.###.#.#.#..######...................................................
.#.....#...#.#.........................................................
.##########..#............#......................#.....................
.#.....#.....#.#.......#...............................................
.###..##...#.#..#................#.....................................
...#...........#.....#...........................#.....................
##.###.###.............................................................
.#...#.#.....#.#.......................................................
.###.##....#..#..................................#........#...#........
...#...#...............................................................
.#.###.#.#......#...#.........................##.#..........#....#.....
...#...#.........................................#.....................
.....###.#...........................#..........#......................
.#.....................................................................
....#....................................#.......#.......#.##.##.#.....
...........................................#.....#.................#...
.........#.......................#.#.........###.###.........##.#.#....
.......................................#.....#...........#.#...........
.....................................#.###..##.######....#.#...##......
...................................#...#...#...#.....#.#...#.#.........
.........#.......................###.###.###.###.###.......#.##..###...
.....................................#...........#.......#.............
.........................#......##.#######.##########..#..##.#.#..##...
.................................#.#.....#.#.........#.#.#...#.#...#...
.........................#.##......#.#.#.###.###.....##..#.##..###.#...
...............................#...#.#.#.#...#.....#.....#.........#...
.........................#.####.##..##.#.#.##..###.###..#.##########...
.....................#.....#.......#...#...#.........#.#.......#.......
.............................#.#.###.######.#....#...#.#.#####.#######.
.............#.........#.....#...#...#.......#...#...#.#...#.#.....#...
..................#....#.##.######.#.#.#####.#...#...#.###.#.#####.#..#
...........................#.....#.#...#.....#.........#...#...#.......
........................##.###.#.#.#####.####..###.#.#.#.###.#.#.#.#...
.........................#...#.#.......#...#.....#.....#.....#.#.#.#...
.......................#.###.#####.#####.#.#####.#......####.###.......
.....................#.....#.....#.#...#.#.....#...........#.#.........
.....................#..##.#####.###.#.#.#####.###.#########.#..#...##.
...........................#.....#...#.#.#...#...#...#.......#.....#...
...........................#....##.###.#.###..##.#..##.########...#..##
.......................#.....#.....#...#.....#.#.#.#...#.......#.....#.
.......................#.#.###.#####.##.####.#.#.#.#.###.#####.#...###.
.........................#.....#.....#.#...#...#.#.#.#...#...#.#...#...
.................#.....#.#..####.#####.#.#.###.#.###.#.##..###.####.##.
.................#.........#...#.#.....#.#.....#.#...#.....#...........
.............................#.#.#.###.#..######.#.#######.#.#########.
.................................#.#.#.#.#.......#.#...#...#...#.....#.
...................#...#.#...###.#.#.#.#.#.######..#.#.#######.###.###.
...........................#.#...#...#...#.#.....#...#.......#...#.#...
...............#.........#####.#####.#####.#.###.####.######.###.#.#.##
.........................#.....#...#.#...#...#.#.....#.....#.....#.#.#.
.................................#.#.###.####...##.###.###.#######.#.#.
.................................................#.......#.............
